####################
#..................#
#.............####.#
#.....P............#
#..................#
####################

