%%%%%%%%%%%%%%%%%%%%%%%%%%%%%%%%%%%%%%%%%%%%%%%%%%%%%%%%%%%%%%%%%%%%%%%  
%                                                                     %  
%                                                                     %  
%                    ┌────┬────────────────┬────┐                     %  
%                    │🐟  │        N       │    │                     %  
%                    │    │  ──────────────┤ 🐠 │                     %  
%                    ├────┘                └────┼                     %  
%                    │                          │                     %  
%                    ┼──┐                       │                     %  
%                    │🥩│                    ┌──┤                     %  
%                    │🍖│                    │🥩│                     %  
%                    ├──┘                    └──┤                     %  
%                    │                       ┌──┼                     %  
%                    │                       │🍖│                     %  
%                    │ ├┐┬┌┤                 └──┼                     %  
%                    │                          │                     %  
%                    └────────────DD────────────┘                     %  
%                                                                     %  
%                                                                     %  
%%%%%%%%%%%%%%%%%%%%%%%%%%%%%%%%%%%%%%%%%%%%%%%%%%%%%%%%%%%%%%%%%%%%%%%  