%%%%%%%%%%%%%%%%%%%%%%%%%%%%%%%%%%%%%%%%%%%%%%%%%%%%%%%%%%%%%%%%%%%%%%%  
%                                                                     %  
%                                                                     %  
%                    ┌────┬────────────────┬────┐                     %  
%                    │🐟£  │        N       │    │                     %  
%                    │    │  ──────────────┤ 🐠£ │                     %  
%                    ├────┘                └────┼                     %  
%                    │                          │                     %  
%                    ┼──┐                       │                     %  
%                    │🥩£│                    ┌──┤                     %  
%                    │🍖£│                    │🥩£│                     %  
%                    ├──┘                    └──┤                     %  
%                    │                       ┌──┼                     %  
%                    │                       │🍖£│                     %  
%                    │ ├┐┬┌┤                 └──┼                     %  
%                    │                          │                     %  
%                    └────────────DD────────────┘                     %  
%                                                                     %  
%                                                                     %  
%%%%%%%%%%%%%%%%%%%%%%%%%%%%%%%%%%%%%%%%%%%%%%%%%%%%%%%%%%%%%%%%%%%%%%%  