%%%%%%%%%%%%%%%%%%%%%%%%%%%%%%%%%%%%%%%%%%%%%%%%%%%%%%%%%%%%%%%%%%%%%%%
%                                                                     %
%                                                                     %
%                                                                     %
%                                                                     %
%                                                                     %
%                                                                     %
%                                                                     %
%                                  Cave                               %
%                                                                     %
%                                                                     %
%                                                                     %
%                                                                     %
%                                                                     %
%                                                                     %
%                                                                     %
%                                                                     %
%                                                                     %
%                                  |   |                              %
%%%%%%%%%%%%%%%%%%%%%%%%%%%%%%%%%%%%%%%%%%%%%%%%%%%%%%%%%%%%%%%%%%%%%%%