%%%%%%%%%%%%%%%%%%%%%%%%%%%%%%%%%%%%%%%%%%%%%%%%%%%%%%%%%%%%%%%%%%%%%%%
% 🪨£                        🪨£              🪨£                        %
%                  🪨£                                  🪨£             %
%                                           🪨£        🪨£   🪨£         %
%           🪨£                🪨£       🪨£  🪨£                         %
%               🪨£                  🪨£                🪨£              %
%                  🪨£                     🪨£                      🪨£  %
%           🪨£                     🪨£   🪨£                            %
%                       🪨£                                      🪨£    %
%      🪨£                   🪨£                            🪨£          %
%           🪨£                                      🪨£                %
%                             🪨£       🪨£                             %
%                  🪨£             🪨£       🪨£          🪨£   🪨£  🪨£    %
%                          🪨£                    🪨£             🪨£    %
%                                   🪨£                                %
%       🪨£                                       🪨£                   %
%                                   🪨£                                %
%                             🪨£     🪨£                  🪨£           %
%   🪨£                       🪨£       🪨£                              %
%%%%%%%%%%%%%%%%%%%%%%%%%%%%%%%%%%%%%%%%%%%%%%%%%%%%%%%%%%%%%%%%%%%%%%%