┌─────────────────────────────────────────────────────────────────────┐
│                                                                     │
│                                                                     │
│                                                                     │
│                                                                     │
│                                                                     │
│                                                                     │
│                                                                     │
│                                                                     │
│                                                                     │
│                                                                     │
│                                                                     │
│                                                                     │
│                                                                     │
│                                                                     │
│                                                                     │
│                                                                     │
│                                                                     │
│                                                                     │
├─────────────────────────────────────────────────────────────────────┤
│                                                                     │
│                                                                     │
│                                                                     │
│                                                                     │
│                                                                     │
│                                                                     │
│                                                                     │
│                                                                     │
│                                                                     │
│                                                                     │
│                                                                     │
│                                                                     │
│                                                                     │
│                                                                     │
│                                                                     │
│                                                                     │
│                                                                     │
└─────────────────────────────────────────────────────────────────────┘


















