%%%%%%%%%%%%%%%%%%%%%%%%%%%%%%%%%%%%%%%%%%%%%%%%%%%%%%%%%%%%%%%%%%%%%%%
%          🌲£                                       🌲£                %
%              🌲£      🌲£         🌲£🌲£    🌲£    🌲£           🌲£       %
%                  🌲£🌲£            🌲£                 🌲£ 🌲£           %
%        🌲£   🌲£🌲£      🌲£ 🌲£ 🌲£🌲£        🌲£    🌲£ 🌲£      🌲£      🌲£ %
%      🌲£    🌲£   🌲£    🌲£        🌲£    🌲£  🌲£🌲£   🌲£   🌲£      🌲£    %
%           🌲£🌲£  🌲£                      🌲£           🌲£ 🌲£          %
%      🌲£   🌲£    🌲£                              🌲£       🌲£🌲£🌲£     %
%           🌲£         🌲£     🦎£ 🪨£🪨£🪨£🪨£      🌲£        🌲£🌲£  🌲£     %
%   🌲£      🌲£     🌲£         🪨£🪨£  🪨£🪨£      🌲£     🌲£       🌲£      %
%      🌲£                🌲£ 🪨£🪨£     🪨£🪨£            🌲£    🌲£         %
%         🌲£        🌲£                        🌲£       🌲£      🌲£     %
%    🌲£       🌲£   🌲£  🌲£                      🌲£   🌲£      🌲£        %
%            🌲£                     🌲£     🌲£         🌲£         🌲£   %
%        🌲£                   🌲£                                      %
%           🌲£   🌲£    🌲£           🌲£          🌲£   🌲£   🌲£    🌲£    %
%       🌲£   🌲£        🌲£                        🌲£    🌲£             %
%                   🌲£   🌲£            🌲£            🌲£               %
%                      🌲£                🌲£                  🌲£       %
%%%%%%%%%%%%%%%%%%%%%%%%%%%%%%%%%%%%%%%%%%%%%%%%%%%%%%%%%%%%%%%%%%%%%%%