%%%%%%%%%%%%%%%%%%%%%%%%%%%%%%%%%%%%%%%%%%%%%%%%%%%%%%%%%%%%%%%%%%%%%%%
%                                                                     %
%                                                                     %
%                                                                     %
%                                                                     %
%     ┌───────────────┬───────────┐                                   %
%     │               │           │                                   %
%     │               │           ├─────────────────────┐             %
%     │               │           │                     │             %
%     │               │           │                     │             %
%     │               │           │                     │             %
%     │───────────────┘           │                     │             %
%     │                                                 │             %
%     │                                   🔨            │             %
%     │                           │       ◥█◤           │             %
%     │                           │                     │             %
%     │                           │                     │             %
%     │                           │                     │             %
%     └─────────────  ────────────┴─────────────────────┘             %
%%%%%%%%%%%%%%%%%%%%%%%%%%%%%%%%%%%%%%%%%%%%%%%%%%%%%%%%%%%%%%%%%%%%%%%