%%%%%%%%%%%%%%%%%%%%%%%%%%%%%%%%%%%%%%%%%%%%%%%%%%%%%%%%%%%%%%%%%%%%%%%
%                │          │      🕖£      │          │    💰£ 💰£  💰£  %
%                │          │              │          │     💰£  💰£    %
%                │          │  🎒£   🪑£     │          │           💰£  %
%    📖£       📖£ │          │           🪑£ │          │               %
%────────┘👱£└────┘          │              │          └───┘👨£└💼£──────%
%                           └──────┘👩£└────┘                          %
%                                                                     %
%                                                                   ┌─%
%                                                               ┌───┘ %
%📮£                                                       ┌─────┘     %
%──────────────┐                                ┌─────────┘    🌳£     %
%              └──────────────  ────────────────┘                     %
%                                                                     %
%     🌳£         🌳£                            🌳£      🌳£             %
%                       🌳£        🌳£                        🌳£        %
%               🌳£                        🌳£                          %
%                                                                     %
%      🌳£              🌳£                          🌳£       🌳£        %
%%%%%%%%%%%%%%%%%%%%%%%%%%%%%%%%%%%%%%%%%%%%%%%%%%%%%%%%%%%%%%%%%%%%%%%