%%%%%%%%%%%%%%%%%%%%%%%%%%%%%%%%%%%%%%%%%%%%%%%%%%%%%%%%%%%%%%%%%%%%%%%
%                │          │      🕖      │          │    💰 💰  💰  %
%                │          │              │          │     💰  💰    %
%                │          │  🎒   🪑     │          │           💰  %
%    📖       📖 │          │           🪑 │          │               %
%────────┘👱└────┘          │              │          └───┘👨└💼──────%
%                           └──────┘👩└────┘                          %
%                                                                     %
%                                                                   ┌─%
%                                                               ┌───┘ %
%📮                                                       ┌─────┘     %
%──────────────┐                                ┌─────────┘    🌳     %
%              └──────────────DD────────────────┘                     %
%                                                                     %
%     🌳         🌳                            🌳      🌳             %
%                       🌳        🌳                        🌳        %
%               🌳                        🌳                          %
%                                                                     %
%      🌳              🌳                          🌳       🌳        %
%%%%%%%%%%%%%%%%%%%%%%%%%%%%%%%%%%%%%%%%%%%%%%%%%%%%%%%%%%%%%%%%%%%%%%%