##############################
#                            #
#        MMMMM               #
#        M   M               #
#        M   M               #
#                            #
#             P              #
#                            #
#                            #
##############################