%%%%%%%%%%%%%%%%%%%%%%%%%%%%%%%%%%%%%%%%%%%%%%%%%%%%%%%%%%%%%%%%%%%%%%%
%                                  │   │                              %
%──────────────────┐               │   │                  ┌─────┐     %
%                  └────────────┐  │   │    ┌─────────────┘     │     %
%                               └──┤   ├────┘                   └─────%
%                                  │   │                              %
%                                                                     %
%                                                                     %
%                                                                     %
%                                                                     %
%  ▲                                                       ▲          %
% /─\                                                     /─\         %
% │ │                                                     │ │         %
% ├D┤                    ┌                                ├D┤         %
%       ▲                                           ▲                 %
%      /─\                                         /─\                %
%      │ │                                         │ │                %
%      ├D┤                                         ├D┤                %
%                                                                     %
%%%%%%%%%%%%%%%%%%%%%%%%%%%%%%%%%%%%%%%%%%%%%%%%%%%%%%%%%%%%%%%%%%%%%%%