##################################################
#                                                #
#            ######                              #
#            ## ###                              #
#                                                #
#                       P                        #
#                                                #
#                                                #
##################################################