%%%%%%%%%%%%%%%%%%%%%%%%%%%%%%%%%%%%%%%%%%%%%%%%%%%%%%%%%%%%%%%%%%%%%%%   
%                                                                     %   
%                                                                     %   
%                    ┌──────────────────────────┐                     %   
%                    │        🎷£          🎸£  🎭£│                     %   
%                    │🪜£▀▀█          🎺£     █▀▀▀│                     %   
%                    │🪜£  ▀▀▀█         █▀▀▀▀▀   │                     %   
%                    │       ▀▀▀▀▀▀▀▀▀▀▀        │                     %   
%                    │                          │                     %   
%                    │                          │                     %   
%                    │            N             │                     %   
%                    │                          │                     %   
%                    │ ├┐┬┌┤              ├┐┬┌┤ │                     %   
%                    │                          │                     %   
%                    │      ├┐┬┌┤      ├┐┬┌┤    D                     %   
%                    │                          │                     %   
%                    └──────────────────────────┘                     %   
%                                                                     %   
%                                                                     %   
%%%%%%%%%%%%%%%%%%%%%%%%%%%%%%%%%%%%%%%%%%%%%%%%%%%%%%%%%%%%%%%%%%%%%%%