%%%%%%%%%%%%%%%%%%%%%%%%%%%%%%%%%%%%%%%%%%%%%%%%%%%%%%%%%%%%%%%%%%%%%%%   
%                                                                     %   
%                                                                     %   
%                    ┌──────────────────────────┐                     %   
%                    │      🎷£          🎸£  🎭│                     %   
%                    │🪜▀█          🎺£     █▀▀▀│                     %   
%                    │🪜£▀▀▀▀█         █▀▀▀▀▀   │                     %   
%                    │       ▀▀▀▀▀▀▀▀▀▀▀        │                     %   
%                    │                          │                     %   
%                    │                          │                     %   
%                    │            N             │                     %   
%                    │                          │                     %   
%                    │ ├┐┬┌┤                    │                     %   
%                    │                          │                     %   
%                    │      ├┐┬┌┤      ├┐┬┌┤    │                     %   
%                    │                          │                     %   
%                    └────────────DD────────────┘                     %   
%                                                                     %   
%                                                                     %   
%%%%%%%%%%%%%%%%%%%%%%%%%%%%%%%%%%%%%%%%%%%%%%%%%%%%%%%%%%%%%%%%%%%%%%%