%%%%%%%%%%%%%%%%%%%%%%%%%%%%%%%%%%%%%%%%%%%%%%%%%%%%%%%%%%%%%%%%%%%%%%% 
%                                                                     % 
%     ┼┼┼┼┼┼┼┼┼┼       ┼┼┼┼┼┼┼┼┼┼      ┼┼┼┼┼┼┼┼┼┼       ┼┼┼┼┼┼┼┼┼┼    % 
%     ┼        ┼       ┼        ┼      ┼        ┼       ┼        ┼    % 
%     ┼        ┼       ┼        ┼      ┼        ┼       ┼        ┼    % 
%     ┼        ┼       ┼        ┼      ┼        ┼       ┼        ┼    % 
%     ┼┼┼┼┼┼┼┼┼┼       ┼┼┼┼┼┼┼┼┼┼      ┼┼┼┼┼┼┼┼┼┼       ┼┼┼┼┼┼┼┼┼┼    % 
%                                                                     % 
%                                                                     % 
%                                                                ─ ─ ─% 
%                                                                     % 
%                                                         /\     ─ ─ ─% 
%                                                        /  \         % 
%     ┼┼┼┼┼┼┼┼┼┼       ┼┼┼┼┼┼┼┼┼┼      ┼┼┼┼┼┼┼┼┼┼       /────\        % 
%     ┼        ┼       ┼        ┼      ┼        ┼       │┌┐┌┐│        % 
%     ┼        ┼       ┼        ┼      ┼        ┼       │└┘└┘│        % 
%     ┼        ┼       ┼        ┼      ┼        ┼       │    D        % 
%     ┼┼┼┼┼┼┼┼┼┼       ┼┼┼┼┼┼┼┼┼┼      ┼┼┼┼┼┼┼┼┼┼       ├────┼─┐_     % 
%                                                       │    │XXX]┬   % 
%%%%%%%%%%%%%%%%%%%%%%%%%%%%%%%%%%%%%%%%%%%%%%%%%%%%%%%%%%%%%%%%%%%%%%% 