%%%%%%%%%%%%%%%%%%%%%%%%%%%%%%%%%%%%%%%%%%%%%%%%%%%%%%%%%%%%%%%%%%%%%%% 
%                                                                     % 
%  ┼┼┼┼┼┼┼┼┼┼       ┼┼┼┼┼┼┼┼┼┼      ┼┼┼┼┼┼┼┼┼┼       ┼┼┼┼┼┼┼┼┼┼       % 
%  ┼        ┼       ┼        ┼      ┼        ┼       ┼        ┼       % 
%  ┼        ┼       ┼        ┼      ┼        ┼       ┼        ┼       % 
%  ┼        ┼       ┼        ┼      ┼        ┼       ┼        ┼       % 
%  ┼┼┼┼┼┼┼┼┼┼🪧£     ┼┼┼┼┼┼┼┼┼┼🪧£    ┼┼┼┼┼┼┼┼┼┼🪧£     ┼┼┼┼┼┼┼┼┼┼🪧£     % 
%                                                                     % 
%                                                                     % 
%                                                                ─ ─ ─% 
%                                                                     % 
%                                                      /\        ─ ─ ─% 
%                                                     /  \            % 
%  ┼┼┼┼┼┼┼┼┼┼🪧£     ┼┼┼┼┼┼┼┼┼┼🪧£    ┼┼┼┼┼┼┼┼┼┼🪧£     /────\           % 
%  ┼        ┼       ┼        ┼      ┼        ┼       │┌┐┌┐│─[Z]       % 
%  ┼        ┼       ┼        ┼      ┼        ┼       │└┘└┘│           % 
%  ┼        ┼       ┼        ┼      ┼        ┼       │    │           % 
%  ┼┼┼┼┼┼┼┼┼┼       ┼┼┼┼┼┼┼┼┼┼      ┼┼┼┼┼┼┼┼┼┼       └─DD─┘           % 
%                                                                     % 
%%%%%%%%%%%%%%%%%%%%%%%%%%%%%%%%%%%%%%%%%%%%%%%%%%%%%%%%%%%%%%%%%%%%%%% 