%%%%%%%%%%%%%%%%%%%%%%%%%%%%%%%%%%%%%%%%%%%%%%%%%%%%%%%%%%%%%%%%%%%%%%% 
%                                                                     % 
%                                                                     % 
%                                                                     % 
%                                                                     %
%                    ┌────────────────────┬───┬─┐                     % 
%                    │┌────┐    /         ┼🔥£ ┼ │                     % 
%                    ││+  ││    │         │───│ │                     % 
%                    │└────┘    │           N   │                     % 
%                    ├──────────┘               │                     % 
%                    │                          │                     % 
%                    │                          │                     % 
%                    │ ├┐┬┌┤                    │                     % 
%                    │                          │                     % 
%                    └────────────DD────────────┘                     % 
%                                                                     % 
%                                                                     % 
%                                                                     % 
%                                                                     % 
%%%%%%%%%%%%%%%%%%%%%%%%%%%%%%%%%%%%%%%%%%%%%%%%%%%%%%%%%%%%%%%%%%%%%%% 